####...#.#.#..##
*...##.....##..#
#...##....#....#
#......#...#...#
#...#.#.#..#...#
#.#.#......#...#
##..##...##..###
#..####@....##..